S 1 1 5 5 5
1 1 1 5 5 5
2 2 1 1 5 5
2 2 2 1 1 1
3 3 2 2 1 E
